"filename", "language", "Markdown", "Java", "comment", "blank", "total"
"c:\Computer Science Stuff\Compiler\Monkey_java\README.md", "Markdown", 16, 0, 0, 8, 24
"c:\Computer Science Stuff\Compiler\Monkey_java\src\CodeTest.java", "Java", 0, 70, 1, 12, 83
"c:\Computer Science Stuff\Compiler\Monkey_java\src\CompilerTest.java", "Java", 0, 165, 0, 16, 181
"c:\Computer Science Stuff\Compiler\Monkey_java\src\Compiler\Bytecode.java", "Java", 0, 26, 0, 11, 37
"c:\Computer Science Stuff\Compiler\Monkey_java\src\Compiler\Compiler.java", "Java", 0, 61, 1, 16, 78
"c:\Computer Science Stuff\Compiler\Monkey_java\src\Compiler\CompilerError.java", "Java", 0, 6, 0, 3, 9
"c:\Computer Science Stuff\Compiler\Monkey_java\src\EvalObject\ArrayObj.java", "Java", 0, 35, 0, 14, 49
"c:\Computer Science Stuff\Compiler\Monkey_java\src\EvalObject\BooleanObj.java", "Java", 0, 25, 0, 11, 36
"c:\Computer Science Stuff\Compiler\Monkey_java\src\EvalObject\Builtin.java", "Java", 0, 20, 0, 10, 30
"c:\Computer Science Stuff\Compiler\Monkey_java\src\EvalObject\BuiltinFunction.java", "Java", 0, 5, 0, 3, 8
"c:\Computer Science Stuff\Compiler\Monkey_java\src\EvalObject\Builtins.java", "Java", 0, 90, 3, 20, 113
"c:\Computer Science Stuff\Compiler\Monkey_java\src\EvalObject\Environment.java", "Java", 0, 35, 0, 14, 49
"c:\Computer Science Stuff\Compiler\Monkey_java\src\EvalObject\ErrorObj.java", "Java", 0, 18, 0, 8, 26
"c:\Computer Science Stuff\Compiler\Monkey_java\src\EvalObject\EvalObject.java", "Java", 0, 5, 0, 4, 9
"c:\Computer Science Stuff\Compiler\Monkey_java\src\EvalObject\FunctionObj.java", "Java", 0, 44, 0, 14, 58
"c:\Computer Science Stuff\Compiler\Monkey_java\src\EvalObject\HashKey.java", "Java", 0, 28, 0, 6, 34
"c:\Computer Science Stuff\Compiler\Monkey_java\src\EvalObject\HashObj.java", "Java", 0, 57, 0, 15, 72
"c:\Computer Science Stuff\Compiler\Monkey_java\src\EvalObject\Hashable.java", "Java", 0, 4, 0, 3, 7
"c:\Computer Science Stuff\Compiler\Monkey_java\src\EvalObject\IntegerObj.java", "Java", 0, 26, 0, 12, 38
"c:\Computer Science Stuff\Compiler\Monkey_java\src\EvalObject\NullObj.java", "Java", 0, 13, 0, 6, 19
"c:\Computer Science Stuff\Compiler\Monkey_java\src\EvalObject\Pair.java", "Java", 0, 11, 0, 5, 16
"c:\Computer Science Stuff\Compiler\Monkey_java\src\EvalObject\ReturnObj.java", "Java", 0, 15, 0, 8, 23
"c:\Computer Science Stuff\Compiler\Monkey_java\src\EvalObject\StringObj.java", "Java", 0, 20, 0, 10, 30
"c:\Computer Science Stuff\Compiler\Monkey_java\src\EvaluatorTest.java", "Java", 0, 445, 7, 89, 541
"c:\Computer Science Stuff\Compiler\Monkey_java\src\Evaluator\Evaluator.java", "Java", 0, 338, 2, 52, 392
"c:\Computer Science Stuff\Compiler\Monkey_java\src\LexerTest.java", "Java", 0, 78, 0, 11, 89
"c:\Computer Science Stuff\Compiler\Monkey_java\src\Lexer\Lexer.java", "Java", 0, 154, 0, 23, 177
"c:\Computer Science Stuff\Compiler\Monkey_java\src\Main.java", "Java", 0, 6, 0, 5, 11
"c:\Computer Science Stuff\Compiler\Monkey_java\src\ParserTest.java", "Java", 0, 600, 13, 197, 810
"c:\Computer Science Stuff\Compiler\Monkey_java\src\Parser\Parser.java", "Java", 0, 367, 0, 75, 442
"c:\Computer Science Stuff\Compiler\Monkey_java\src\REPL.java", "Java", 0, 68, 1, 13, 82
"c:\Computer Science Stuff\Compiler\Monkey_java\src\Token\Token.java", "Java", 0, 22, 0, 8, 30
"c:\Computer Science Stuff\Compiler\Monkey_java\src\Token\TokenType.java", "Java", 0, 54, 4, 16, 74
"c:\Computer Science Stuff\Compiler\Monkey_java\src\VMTest.java", "Java", 0, 79, 0, 14, 93
"c:\Computer Science Stuff\Compiler\Monkey_java\src\ast\ArrayLiteral.java", "Java", 0, 36, 0, 15, 51
"c:\Computer Science Stuff\Compiler\Monkey_java\src\ast\BlockStatement.java", "Java", 0, 30, 0, 10, 40
"c:\Computer Science Stuff\Compiler\Monkey_java\src\ast\Boolean.java", "Java", 0, 21, 0, 10, 31
"c:\Computer Science Stuff\Compiler\Monkey_java\src\ast\CallExpression.java", "Java", 0, 35, 0, 9, 44
"c:\Computer Science Stuff\Compiler\Monkey_java\src\ast\Expression.java", "Java", 0, 4, 0, 3, 7
"c:\Computer Science Stuff\Compiler\Monkey_java\src\ast\ExpressionStatement.java", "Java", 0, 20, 0, 9, 29
"c:\Computer Science Stuff\Compiler\Monkey_java\src\ast\FunctionLiteral.java", "Java", 0, 44, 0, 13, 57
"c:\Computer Science Stuff\Compiler\Monkey_java\src\ast\HashLiteral.java", "Java", 0, 35, 0, 12, 47
"c:\Computer Science Stuff\Compiler\Monkey_java\src\ast\Identifier.java", "Java", 0, 21, 0, 9, 30
"c:\Computer Science Stuff\Compiler\Monkey_java\src\ast\IfExpression.java", "Java", 0, 43, 0, 13, 56
"c:\Computer Science Stuff\Compiler\Monkey_java\src\ast\IndexExpression.java", "Java", 0, 28, 0, 10, 38
"c:\Computer Science Stuff\Compiler\Monkey_java\src\ast\InfixExpression.java", "Java", 0, 24, 0, 9, 33
"c:\Computer Science Stuff\Compiler\Monkey_java\src\ast\IntegerLiteral.java", "Java", 0, 27, 0, 11, 38
"c:\Computer Science Stuff\Compiler\Monkey_java\src\ast\LetStatement.java", "Java", 0, 36, 0, 11, 47
"c:\Computer Science Stuff\Compiler\Monkey_java\src\ast\PrefixExpression.java", "Java", 0, 27, 0, 11, 38
"c:\Computer Science Stuff\Compiler\Monkey_java\src\ast\Program.java", "Java", 0, 30, 0, 10, 40
"c:\Computer Science Stuff\Compiler\Monkey_java\src\ast\ProgramNode.java", "Java", 0, 5, 0, 4, 9
"c:\Computer Science Stuff\Compiler\Monkey_java\src\ast\ReturnStatement.java", "Java", 0, 26, 0, 14, 40
"c:\Computer Science Stuff\Compiler\Monkey_java\src\ast\Statement.java", "Java", 0, 4, 0, 3, 7
"c:\Computer Science Stuff\Compiler\Monkey_java\src\ast\StringLiteral.java", "Java", 0, 27, 0, 11, 38
"c:\Computer Science Stuff\Compiler\Monkey_java\src\code\Code.java", "Java", 0, 49, 0, 15, 64
"c:\Computer Science Stuff\Compiler\Monkey_java\src\code\Definition.java", "Java", 0, 15, 0, 6, 21
"c:\Computer Science Stuff\Compiler\Monkey_java\src\code\Instructions.java", "Java", 0, 60, 0, 9, 69
"c:\Computer Science Stuff\Compiler\Monkey_java\src\code\Opcode.java", "Java", 0, 25, 0, 7, 32
"c:\Computer Science Stuff\Compiler\Monkey_java\src\vm\ExecutionError.java", "Java", 0, 6, 0, 3, 9
"c:\Computer Science Stuff\Compiler\Monkey_java\src\vm\VM.java", "Java", 0, 68, 0, 18, 86
"Total", "-", 16, 3736, 32, 987, 4771